R 800 600

NO ./textures/wall1.xpm
EA ./textures/wall2.xpm
WE ./textures/wall3.xpm
SO ./textures/wall4.xpm

C 70,113,213
F 166,74,0 

111111111111111111111111
100000000000000000000001
100000000000000000000001
100000000000000000000001
100000000000000000000001
100000000000000000000001
100000000000000000000001
100000000000000010000001
100000000100000000000001
110000000000000000000011
100000000000000000000001
100000000000000000000001
100000000000000000000001
110000000000000000000001
100000000000000000000011
100000000000000000000001
100000000000000000000001
100000000000000000000001
100000000000000000000001
100000000000000000000001
100000000000000000000001
100000000000S00000000001
100000000000000000000001
111111111111111111111111
