111111
100001
110001111111111111111111111111111111111
100000000000000000000000000000000000001
100W00000000000000000000000000000000001111111111111111111111111111111111111111
100000000000000000000000000000000000001100000000000000000000000000000000000001
100000000000000000000000000000000000001100000000000000000000000000000000000001
100000000000000000000000000000000000000000000000000000000000000000000000000001
100000000000000000000000000000000000000000000000000000000010000000000000000001
100000000000000000000000000000000000000000000000000000000010000000000000000001
100000000000000000000000000000000000001000000000000000000011000000000000000001
100000001111111111111110000000000000001000000000000000000001100000000000000001
100000000000000000000010000000000000001000000000000000000000110000000000000001
100000000000000000000010000000000000001000000000000000000000011000000000000001
100000000000000000000010000000000000001000001111100000000000001100000000000001
100000000000000000000011111111111111111000000000100000000000000110000000000001
100000000000000000000000000000000000000000000000111100000000000011000000000001
100000000000000000000000000000000000000000000000100000000000000001111000000001
100000000000000000000000000000000000000000000000000000000000000000000000000001
100000000000000000000000000000000000000000000000000000000000000000000000000001
100000000000000000000000000000000000000000000000000000000000000000000000000001
100000000000000000000000000000000000000000000000000000000000000000000000000001
100000000000000000000000000000000000000000000000000000000000000000000000000001
100000000000000000000000000000000000000000000000000000000000000000000000000001
100000000000000000000000000000000000000000000000000000000000000000000000000001
100000000000000000000000000000000000000000000000000000000000000000000000000001
100000000000000000000000000000000000000000000000000000000000000000000000000001
100000000000000000000000000000000000000000000000000000000000000000000000000001
100000000000000000000000000000000000000000000000000000000000000000000000000001
100000000000000000000000000000000000000000000000000000000000000000000000000001
100000000000000000000000000000000000000000000000000000000000000000000000000001
100000000000000000000000000000000000001111111111111111111111111111111111111111
100000000000000000000000000000000000001
111111111111111111111111111111111111111