R  800  600

NO ./textures/wall1.xpm
EA ./textures/wall2.xpm
WE ./textures/wall3.xpm
SO ./textures/wall4.xpm

C 70,113,213
F 166,74,0 

111111111111111111111111111111111111111
100010000000000000000000000000000000001
10N010000100000000000000000000000000001111111111111111111111111111111111111111
100010000100000000000000000000000000001100000000000000000000000000000000000001
100010000100000000000000000000000000001100000000000000000000000000000000000001
100010000100000000000000000000000000000000000000000000000000000000000000000001
100010000100000000000000000000000000000000000000000000000010000000000000000001
100010000100000000000000000000000000000000000000000000000010000000000000000001
100000000100000000000000000000000000001000000000000000000011000000000000000001
100000001111111111111110000000000000001000000000000000000001100000000000000001
100000000001000000000010000000000000001000000000000000000000110000000000000001
101111111110000000000010000000000000001000000000000000000000011000000000000001
100000000000000000000010000000000000001000001111100000000000001100000000000001
100000000000000000000011111111111111111000000000100000000000000110000000000001
100000000000000000000000000000000000000000000000111100000000000011000000000001
100000000000000000000000000000000000000000000000100000000000000001111000000001
100000000000000000000000000000000000000000000000000000000000000000000000000001
100000000000000000000000000000001111000000000000000000000000000000000000000001
100000000000000000000000000000001  1000001100000000000000000000000000000000001
100000000000000000000000000000001111000000000000000000000000000000000000000001
100000000000000000000000000000000000000000000000000000000000000000000000000001
100000000000000000000000000000000000000000000000000000000000000000000000000001
100000000000000000000000000000000000000000000000000000000000000000000000000001
100000000000000000000000000000000000000000000000000000000000000000000000000001
100000000000000000000000000000000000000000000000000000000000000000000000000001
100000000000000000000000000000000000000000000000000000000000000000000000000001
100000000000000000000000000000000000000000000000000000000000000000000000000001
100000000000000000000000000000000000000000000000000000000000000000000000000001
100000000000000000000000000000000000001111111111111111111111111111111111111111
100000000000000000000000000000000000001
111111111111111111111111111111111111111