111111111111111111111111111111111111111
100000000000000000000000000000000000001
122222222222222000000000000000000000001
100020000000002000000000000000000000001
100020020000002000000000000000000000001
100020020000002000000000000000000000001
100020020000002000000000000000000000001
100020020000000000900000000000000000001
100000022222220000000000000000000000001
122222220000000000000000000000000000001
100000000000000000000000000000000000001
1000000000000000000000000S0000000000001
100000000000000000000000000000000000001
100000000000000000000000000000000000001
100000000000000000000000000000000000001
111111111111111111111111111111111111111