11111
100011
1N00011
1000001
1111111